align_pos	consensus_aa	pdb_pos	pdb_aa
1	G	1	T
2	W	2	T
3	P	3	G
4	A	4	V
5	T	5	Y
6	E	6	R
7	V	7	I
8	M	8	M
9	T	9	T
10	A	10	S
11	V	15	A
12	G	16	G
13	L	17	V
14	M	18	M
15	F	NA	-
16	A	NA	-
17	I	NA	-
18	V	NA	-
19	G	NA	-
20	G	NA	-
21	L	NA	-
22	A	NA	-
23	E	NA	-
24	L	NA	-
25	D	NA	-
26	I	NA	-
27	D	NA	-
28	S	NA	-
29	M	NA	-
30	A	NA	-
31	I	NA	-
32	P	NA	-
33	M	NA	-
34	T	NA	-
35	I	19	V
36	A	20	E
37	G	21	G
38	L	22	V
39	M	23	F
40	F	24	H
41	A	25	T
42	A	26	L
43	F	27	W
44	V	28	H
45	I	29	T
46	S	30	T
47	G	31	K
48	K	32	G
49	S	33	A
50	T	34	A
51	D	35	L
52	M	36	M
53	W	37	S
54	I	38	G
55	E	39	E
56	R	40	G
57	T	41	R
58	A	42	L
59	D	43	D
60	I	44	P
61	S	45	Y
62	W	46	W
63	E	47	G
64	S	48	S
65	D	49	V
66	A	50	K
67	E	51	E
68	I	NA	-
69	T	NA	-
70	G	NA	-
71	S	NA	-
72	S	NA	-
73	E	52	D
74	R	53	R
75	V	54	L
76	D	55	C
77	V	56	Y
78	R	NA	-
79	L	NA	-
80	D	NA	-
81	D	NA	-
82	D	NA	-
83	G	NA	-
84	N	NA	-
85	F	NA	-
86	Q	NA	-
87	L	NA	-
88	M	NA	-
89	N	NA	-
90	D	NA	-
91	P	NA	-
92	G	57	G
93	A	58	G
94	P	59	P
95	W	60	W
96	K	61	K
97	I	62	L
98	W	66	W
99	M	67	N
100	L	72	V
101	R	73	Q
102	M	74	M
103	V	75	I
104	C	76	V
105	L	77	V
106	A	123	V
107	I	124	I
108	S	125	G
109	A	126	L
110	Y	127	Y
111	T	128	G
112	P	129	N
113	W	130	G
114	A	131	V
115	I	132	I
116	L	133	M
117	P	134	P
118	S	135	N
119	V	NA	-
120	V	NA	-
121	G	136	G
122	F	137	S
123	W	138	Y
124	I	139	I
125	T	140	S
126	L	142	I
127	Q	143	V
128	Y	144	Q
129	T	145	G
130	K	146	E
131	R	147	R
